##########
#P..G....#
#..#####.#
#..#...#.#
#I.#S#D###
#..###...#
#.....B..#
#K.......#
#E...E...#
########X#