#####################
#P...............E.I#
#.....#######.......#
#K..................#
##########D##########
#O..................#
#........#..........#
#......###...B......#
#...###.............#
#........S..#####...#
#.............E.....#
#...................#
#Z............O....X#
#####################
