###########
#P...O...M#
#.T.#.....#
#...##....#
#E...O.##.X
###########