####################
#P....M.M..I.......#
#S.................#
#..#######....######
#.....G.....G......#
#O.......####......#
#K..#....#TZ#......#
#...#....DZTD......#
#...#....#TZ#......#
#........####B.....#
#........#.........#
#F...#####........S#
#.....S....######O.#
#B..........I...Z..#
#E....E....D....E..#
#K...S.............X
####################
