###########
#P....G..M#
#.T.#..P..#
#..X##....#
#....P.##.#
###########